[Continents]
1=12
2=10
3=6
4=14
5=7
6=4
7=5
8=6
9=5
10=8
11=5
12=2
13=1
14=2

[Territories]
1,0,0,1,12,2
2,0,0,1,1,3
3,0,0,1,4,2
4,0,0,1,3,5
5,0,0,1,4,6
6,0,0,1,7,5
7,0,0,1,8,6
8,0,0,1,22,7,9
9,0,0,1,8,10
10,0,0,1,12,9,11
11,0,0,1,10
12,0,0,1,1,10,14

16,0,0,2,14,15
17,0,0,2,39,21
18,0,0,2,41,19,14
19,0,0,2,18,21
20,0,0,2,21
21,0,0,2,22,17,19,31,20
22,0,0,2,8,30,21
13,0,0,2,14
14,0,0,2,16,12,41,18,15,13
15,0,0,2,16,76,14

23,0,0,3,25,24,29
24,0,0,3,27,25,26,23
25,0,0,3,26,30,23,24,29
26,0,0,3,27,25,28,32,24
27,0,0,3,43,26,28,24
28,0,0,3,33,44,27,43,26

32,0,0,4,33,26,30,35
33,0,0,4,44,28,52,53,32,34
34,0,0,4,33,38,54,53,37
35,0,0,4,36,32
36,0,0,4,39,31,35,37
37,0,0,4,38,44,39,36,34
38,0,0,4,39,54,37,34,64
39,0,0,4,38,17,41,36,37,40
40,0,0,4,42,39,41
41,0,0,4,39,14,18,40
42,0,0,4,40
29,0,0,4,25,30,23
30,0,0,4,22,25,31,32,29
31,0,0,4,30,36,21

48,0,0,5,47,49,45,51
49,0,0,5,48,50
43,0,0,5,44,27,28,45
44,0,0,5,33,43,28,52,37,45
45,0,0,5,44,43,47,48
46,0,0,5,47
47,0,0,5,46,48,45

50,0,0,6,49,56,51
51,0,0,6,52,55,53,48,50
52,0,0,6,33,44,53,51
53,0,0,6,33,54,52,34,51

54,0,0,7,38,55,53,34,64
55,0,0,7,58,54,57,56,63,51,64
56,0,0,7,55,57,50
57,0,0,7,58,55,56
58,0,0,7,59,55,57,63

64,0,0,8,38,54,55,62,63
59,0,0,8,58,61,60,63
60,0,0,8,59,61,63
61,0,0,8,66,59,62,60
62,0,0,8,65,61,63,64
63,0,0,8,58,59,55,62,60,64

65,0,0,9,66,67,62
66,0,0,9,65,61,68
67,0,0,9,65,68
68,0,0,9,69,66,67,70
69,0,0,9,70,68

70,0,0,10,69,71,72,68
71,0,0,10,70,86
72,0,0,10,70,74,73
73,0,0,10,80,79,81,74,72
74,0,0,10,75,79,72,73
75,0,0,10,79,76,74,77
76,0,0,10,75,15
77,0,0,10,75,79,78

80,0,0,11,79,78,81,73
81,0,0,11,80,82,73
82,0,0,11,81,83
78,0,0,11,80,79,77
79,0,0,11,80,75,78,74,73,77

83,0,0,12,82,84
84,0,0,12,87,83,85

85,0,0,13,84

86,0,0,14,71,87
87,0,0,14,86,84

